#########
# #     #
# ##### #
#       #
####### #
#   #   #
# ### ###
#       #
#########


4x4